1,1,1,1,1,1,1,1,1,1,1,1,1,1,1
1,1,1,1,1,1,1,1,1,1,1,1,1,1,1
1,1,5,5,5,5,5,5,5,5,5,1,1,1,1
1,1,5,5,5,5,5,5,5,5,5,1,1,1,1
2,0,5,5,5,5,5,5,5,5,5,0,2,1,1
1,1,5,5,5,5,5,5,5,5,5,1,1,1,1
1,1,5,5,5,5,3,5,5,5,5,1,1,1,1
1,1,5,5,5,5,5,5,5,5,5,1,1,1,1
2,0,5,5,5,5,5,5,5,5,5,0,2,1,1
1,1,5,5,5,5,5,5,5,5,5,1,1,1,1
1,1,5,5,5,5,5,5,5,5,5,1,1,1,1
1,1,1,1,1,1,1,1,1,1,1,1,1,1,1